a	#FENGEFU#a#FENGEFU#a [ə]#FENGEFU#   ein#FENGEFU#  
aback	#FENGEFU#aback#FENGEFU#aback [əbæk]#FENGEFU#   erstaunt; rückwärts; überrascht#FENGEFU#  
abacus	#FENGEFU#abacus#FENGEFU#abacus [æbəkəs]#FENGEFU#   Rechenbrett#FENGEFU#  
a bad risc	#FENGEFU#a bad risc#FENGEFU#a bad risc [əbædrisk]#FENGEFU#   ein erhöhtes Risiko#FENGEFU#  
abaft	#FENGEFU#abaft#FENGEFU#abaft [əbæft]#FENGEFU#   hinter#FENGEFU#  
a bag of nerves	#FENGEFU#a bag of nerves#FENGEFU#a bag of nerves [əbægɔfnə:vz]#FENGEFU#   ein Nervenbündel#FENGEFU#  
abandoned	#FENGEFU#abandoned#FENGEFU#abandoned [əbændənd]#FENGEFU#   aufgegeben; aufgelassen; herrenlos; sitzengelassen; verlassen#FENGEFU#  
abandoning	#FENGEFU#abandoning#FENGEFU#abandoning [əbændəniŋ]#FENGEFU#   aufgebend; sitzenlassend#FENGEFU#  
abandonment	#FENGEFU#abandonment#FENGEFU#abandonment [əbændənmənt]#FENGEFU#   Aufgabe; Nichtannahme; Verlassenheit; Verzicht#FENGEFU#  
abandonment of action	#FENGEFU#abandonment of action#FENGEFU#abandonment of action [əbændənməntɔfækʃən]#FENGEFU#   Klagerücknahme#FENGEFU#  
abandonment of domicile	#FENGEFU#abandonment of domicile#FENGEFU#abandonment of domicile [əbændənməntɔfdɔmisail]#FENGEFU#   Aufgabe des Wohnsitzes; Wohnsitzaufgabe#FENGEFU#  
abandonment of option	#FENGEFU#abandonment of option#FENGEFU#abandonment of option [əbændənməntɔfɔpʃən]#FENGEFU#   Optionsaufgabe#FENGEFU#  
abandonment of position	#FENGEFU#abandonment of position#FENGEFU#abandonment of position [əbændənməntɔfpəziʃən]#FENGEFU#   Aufgabe einer Stellung; Stellungsaufgabe#FENGEFU#  
abandonment of service	#FENGEFU#abandonment of service#FENGEFU#abandonment of service [əbændənməntɔfsə:vis]#FENGEFU#   Abschaltung; Serviceabschaltung#FENGEFU#  
abandonment stage	#FENGEFU#abandonment stage#FENGEFU#abandonment stage [əbændənməntsteidʒ]#FENGEFU#   Niedergangsphase#FENGEFU#  
abandons	#FENGEFU#abandons#FENGEFU#abandons [əbændənz]#FENGEFU#   gibt auf; lässt sitzen#FENGEFU#  
abased	#FENGEFU#abased#FENGEFU#abased [əbeist]#FENGEFU#   erniedrigte#FENGEFU#  
abasement	#FENGEFU#abasement#FENGEFU#abasement [əbeismənt] (n)#FENGEFU#   Demütigung; (f )28.5.2000#FENGEFU#  
abases	#FENGEFU#abases#FENGEFU#abases [əbeisiz]#FENGEFU#   erniedrigt#FENGEFU#  
abashed	#FENGEFU#abashed#FENGEFU#abashed [əbæʃt]#FENGEFU#   beschämte#FENGEFU#  
abashedly	#FENGEFU#abashedly#FENGEFU#abashedly [əbæʃdli:]#FENGEFU#   beschämend#FENGEFU#  
abashes	#FENGEFU#abashes#FENGEFU#abashes [əbæʃiz]#FENGEFU#   beschämt#FENGEFU#  
abashing	#FENGEFU#abashing#FENGEFU#abashing [əbæʃiŋ]#FENGEFU#   beschämend; beschämende#FENGEFU#  
abashment	#FENGEFU#abashment#FENGEFU#abashment [əbæʃmənt] (n)#FENGEFU#   Beschämung; (f )28.5.2000#FENGEFU#  
abasing	#FENGEFU#abasing#FENGEFU#abasing [əbeisiŋ]#FENGEFU#   demütigend; erniedrigend#FENGEFU#  
abatable	#FENGEFU#abatable#FENGEFU#abatable [əbeitəbl]#FENGEFU#   abziehbar#FENGEFU#  
abated	#FENGEFU#abated#FENGEFU#abated [əbeitid]#FENGEFU#   verminderte; verringerte#FENGEFU#  
abated contribution	#FENGEFU#abated contribution#FENGEFU#abated contribution [əbeitidkɔntribju:ʃən]#FENGEFU#   niedrigerer Beitrag#FENGEFU#  
abatement	#FENGEFU#abatement#FENGEFU#abatement [əbeitmənt] (n)#FENGEFU#   Herabsetzung; (f )Kürzung; (f )Streichung; (f )Verringerung; (f )#FENGEFU#  
abatement of action	#FENGEFU#abatement of action#FENGEFU#abatement of action [əbeitməntɔfækʃən]#FENGEFU#   Verfahrenseinstellung#FENGEFU#  
abatement of tax	#FENGEFU#abatement of tax#FENGEFU#abatement of tax [əbeitməntɔftæks]#FENGEFU#   Steuernachlass#FENGEFU#  
abates	#FENGEFU#abates#FENGEFU#abates [əbeits]#FENGEFU#   vermindert; verringert#FENGEFU#  
abating	#FENGEFU#abating#FENGEFU#abating [əbeitiŋ]#FENGEFU#   vermindernd; verringernd#FENGEFU#  
abattoir	#FENGEFU#abattoir#FENGEFU#abattoir [æbətwɑ:r]#FENGEFU#   Schlachthaus; Schlachthof#FENGEFU#  
abbacies	#FENGEFU#abbacies#FENGEFU#abbacies [æbəsiz]#FENGEFU#   Amtswürde#FENGEFU#  
abbey	#FENGEFU#abbey#FENGEFU#abbey [əbei] (n)#FENGEFU#   Abtei; (f )28.5.2000#FENGEFU#  
abbot	#FENGEFU#abbot#FENGEFU#abbot [æbət] (n)#FENGEFU#   Abt; (m )28.5.2000#FENGEFU#  
abbreviated	#FENGEFU#abbreviated#FENGEFU#abbreviated [əbri:vieitid]#FENGEFU#   abgekürzte; abgekürztes; verkürztes#FENGEFU#  
abbreviated address	#FENGEFU#abbreviated address#FENGEFU#abbreviated address [əbri:vieitidədres]#FENGEFU#   Kurzadresse; (f )#FENGEFU#  
abbreviated address call	#FENGEFU#abbreviated address call#FENGEFU#abbreviated address call [əbri:vieitidədreskɔ:l]#FENGEFU#   Kurzaufruf; (m )Kurzwahl; (f )28.5.2000#FENGEFU#  
abbreviated addressing	#FENGEFU#abbreviated addressing#FENGEFU#abbreviated addressing [əbri:vieitidədresiŋ]#FENGEFU#   abgekürzte Adressierung#FENGEFU#  
abbreviated dial code	#FENGEFU#abbreviated dial code#FENGEFU#abbreviated dial code [əbri:vieitiddaiəlkoud]#FENGEFU#   Kurzwahlzeichen; (neut )#FENGEFU#  
abbreviated keyboard command	#FENGEFU#abbreviated keyboard command#FENGEFU#abbreviated keyboard command [əbri:vieitidki:bɔ:dkəmɑ:nd]#FENGEFU#   abgekürztes Tastaturkommando#FENGEFU#  
abbreviated version	#FENGEFU#abbreviated version